..##.....S
#.##..###.
#.###.###S
#.....###.
###.#####S
